1111111111
1200000011
1011111011
1000001011
1111011011
1001010001
1011011111
1000000001
1111111101
1111111131
