11111111111111111111111111111111111111111111111111
12000000001111100000000011110000000000000000000001
10111111011111101111111011110111111111111111111001
10000001000000100000000000000000000000000000111001
10111011111110111111111111111111101111111110111001
10000000000000100000000000000000101000000000100001
11111111111011101111101111111011101011111111101101
10000000001000001000100000001000001010000000001001
10111111101111111110101111101111111010111110111101
10100000000000000000100000001000000010000010100001
10101111111111111111111110111111111110111110111101
10001000000000000000000010000000000010000000000001
11101111111111111111111110111111111110111111111101
10000000000000000000000000000000000000000000000001
10111111111111101111111111111111111111111111111001
10000000000000100000000000000000000000000000001001
10111111111111111111111110111111101111101111101001
10000000000000000000000000100000001000001000001001
11111111111111111111111110101111111011101011111001
10000000000000000000000000001000000010001000000001
10111111111111111111111111101111111010101111111101
10100000000000000000000000001000001010001000000001
10101111111111111111111111111111111011111111111001
10000000000000000000000000000000000000000000000001
10111111111111111111111111111111111111111111111101
10000000000000000000000000000000000000000000000001
10111111111111111111111111111111111111111111111101
10000000000000000000000000000000000000000000000001
10111111111111111111111111111111111111111111111101
10000000000000000000000000000000000000000000000001
10111111111111111111111111111111111111111111111101
10000000000000000000000000000000000000000000000001
10111111111111111111111111111111111111111111111101
10000000000000000000000000000000000000000000000001
11111111111111111111111111111111111111111111111101
10000000000000000000000000000000000000000000000001
10111111111111111111111111111111111111111111111101
10000000000000000000000000000000000000000000000001
10111111111111111111111111111111111111111111111101
10000000000000000000000000000000000000000000000001
10111111111111111111111111111111111111111111111101
10000000000000000000000000000000000000000000000001
10111111111111111111111111111111111111111111111101
10000000000000000000000000000000000000000000000001
10111111111111111111111111111111111111111111111101
10000000000000000000000000000000000000000000000001
10111111111111111111111111111111111111111111111101
10000000000000000000000000000000000000000000000031
11111111111111111111111111111111111111111111111111
